#######
#   A##
#  #  #
#o  @ #
# @@#o#
###  o#
#######