#########
##   A ##
##@# ####
#o    ###
#    ####
#@   o###
#       #
#########
